subject,video,type,type_idx,startFrame,endFrame,frame_num,length
1,./CAS(ME)2_longVideoFaceCropped/longVideoFaceCropped/s15/15_0101disgustingteeth,macro-expression,1,1195,1266,2052,71
1,./CAS(ME)2_longVideoFaceCropped/longVideoFaceCropped/s15/15_0102eatingworms,macro-expression,1,396,430,1075,34
1,./CAS(ME)2_longVideoFaceCropped/longVideoFaceCropped/s15/15_0102eatingworms,macro-expression,1,407,435,1075,28
1,./CAS(ME)2_longVideoFaceCropped/longVideoFaceCropped/s15/15_0102eatingworms,macro-expression,1,781,802,1075,21
1,./CAS(ME)2_longVideoFaceCropped/longVideoFaceCropped/s15/15_0102eatingworms,micro-expression,2,699,707,1075,8
1,./CAS(ME)2_longVideoFaceCropped/longVideoFaceCropped/s15/15_0401girlcrashing,macro-expression,1,557,608,3711,51
1,./CAS(ME)2_longVideoFaceCropped/longVideoFaceCropped/s15/15_0401girlcrashing,macro-expression,1,2854,2871,3711,17
1,./CAS(ME)2_longVideoFaceCropped/longVideoFaceCropped/s15/15_0402beatingpregnantwoman,macro-expression,1,2155,2163,4370,8
1,./CAS(ME)2_longVideoFaceCropped/longVideoFaceCropped/s15/15_0402beatingpregnantwoman,macro-expression,1,3363,3383,4370,20
1,./CAS(ME)2_longVideoFaceCropped/longVideoFaceCropped/s15/15_0402beatingpregnantwoman,macro-expression,1,3380,3407,4370,27
1,./CAS(ME)2_longVideoFaceCropped/longVideoFaceCropped/s15/15_0402beatingpregnantwoman,macro-expression,1,3738,3822,4370,84
1,./CAS(ME)2_longVideoFaceCropped/longVideoFaceCropped/s15/15_0402beatingpregnantwoman,macro-expression,1,3761,3779,4370,18
1,./CAS(ME)2_longVideoFaceCropped/longVideoFaceCropped/s15/15_0502funnyerrors,macro-expression,1,178,190,2273,12
1,./CAS(ME)2_longVideoFaceCropped/longVideoFaceCropped/s15/15_0502funnyerrors,macro-expression,1,2203,2227,2273,24
1,./CAS(ME)2_longVideoFaceCropped/longVideoFaceCropped/s15/15_0502funnyerrors,micro-expression,2,138,148,2273,10
1,./CAS(ME)2_longVideoFaceCropped/longVideoFaceCropped/s15/15_0503unnyfarting,macro-expression,1,2457,2510,2811,53
1,./CAS(ME)2_longVideoFaceCropped/longVideoFaceCropped/s15/15_0505funnyinnovations,macro-expression,1,1403,1436,2304,33
2,./CAS(ME)2_longVideoFaceCropped/longVideoFaceCropped/s16/16_0101disgustingteeth,macro-expression,1,167,199,2051,32
2,./CAS(ME)2_longVideoFaceCropped/longVideoFaceCropped/s16/16_0101disgustingteeth,macro-expression,1,333,346,2051,13
2,./CAS(ME)2_longVideoFaceCropped/longVideoFaceCropped/s16/16_0101disgustingteeth,macro-expression,1,697,725,2051,28
2,./CAS(ME)2_longVideoFaceCropped/longVideoFaceCropped/s16/16_0101disgustingteeth,macro-expression,1,915,965,2051,50
2,./CAS(ME)2_longVideoFaceCropped/longVideoFaceCropped/s16/16_0101disgustingteeth,macro-expression,1,1228,1284,2051,56
2,./CAS(ME)2_longVideoFaceCropped/longVideoFaceCropped/s16/16_0101disgustingteeth,macro-expression,1,1792,1836,2051,44
2,./CAS(ME)2_longVideoFaceCropped/longVideoFaceCropped/s16/16_0101disgustingteeth,macro-expression,1,1794,1842,2051,48
2,./CAS(ME)2_longVideoFaceCropped/longVideoFaceCropped/s16/16_0101disgustingteeth,micro-expression,2,552,565,2051,13
2,./CAS(ME)2_longVideoFaceCropped/longVideoFaceCropped/s16/16_0102eatingworms,macro-expression,1,173,248,1075,75
2,./CAS(ME)2_longVideoFaceCropped/longVideoFaceCropped/s16/16_0102eatingworms,macro-expression,1,187,240,1075,53
2,./CAS(ME)2_longVideoFaceCropped/longVideoFaceCropped/s16/16_0102eatingworms,macro-expression,1,317,400,1075,83
2,./CAS(ME)2_longVideoFaceCropped/longVideoFaceCropped/s16/16_0102eatingworms,macro-expression,1,322,356,1075,34
2,./CAS(ME)2_longVideoFaceCropped/longVideoFaceCropped/s16/16_0102eatingworms,macro-expression,1,322,359,1075,37
2,./CAS(ME)2_longVideoFaceCropped/longVideoFaceCropped/s16/16_0102eatingworms,macro-expression,1,420,445,1075,25
2,./CAS(ME)2_longVideoFaceCropped/longVideoFaceCropped/s16/16_0102eatingworms,macro-expression,1,526,543,1075,17
2,./CAS(ME)2_longVideoFaceCropped/longVideoFaceCropped/s16/16_0102eatingworms,macro-expression,1,720,741,1075,21
2,./CAS(ME)2_longVideoFaceCropped/longVideoFaceCropped/s16/16_0102eatingworms,micro-expression,2,270,278,1075,8
2,./CAS(ME)2_longVideoFaceCropped/longVideoFaceCropped/s16/16_0401girlcrashing,macro-expression,1,554,617,3711,63
2,./CAS(ME)2_longVideoFaceCropped/longVideoFaceCropped/s16/16_0401girlcrashing,macro-expression,1,1656,1700,3711,44
2,./CAS(ME)2_longVideoFaceCropped/longVideoFaceCropped/s16/16_0401girlcrashing,macro-expression,1,1741,1780,3711,39
2,./CAS(ME)2_longVideoFaceCropped/longVideoFaceCropped/s16/16_0401girlcrashing,macro-expression,1,3580,3599,3711,19
2,./CAS(ME)2_longVideoFaceCropped/longVideoFaceCropped/s16/16_0402beatingpregnantwoman,macro-expression,1,415,457,4370,42
2,./CAS(ME)2_longVideoFaceCropped/longVideoFaceCropped/s16/16_0402beatingpregnantwoman,macro-expression,1,1382,1416,4370,34
2,./CAS(ME)2_longVideoFaceCropped/longVideoFaceCropped/s16/16_0402beatingpregnantwoman,macro-expression,1,1540,1577,4370,37
2,./CAS(ME)2_longVideoFaceCropped/longVideoFaceCropped/s16/16_0402beatingpregnantwoman,macro-expression,1,1865,1911,4370,46
2,./CAS(ME)2_longVideoFaceCropped/longVideoFaceCropped/s16/16_0402beatingpregnantwoman,macro-expression,1,2149,2210,4370,61
2,./CAS(ME)2_longVideoFaceCropped/longVideoFaceCropped/s16/16_0402beatingpregnantwoman,macro-expression,1,2712,2752,4370,40
2,./CAS(ME)2_longVideoFaceCropped/longVideoFaceCropped/s16/16_0402beatingpregnantwoman,macro-expression,1,2905,2937,4370,32
2,./CAS(ME)2_longVideoFaceCropped/longVideoFaceCropped/s16/16_0402beatingpregnantwoman,macro-expression,1,3409,3461,4370,52
2,./CAS(ME)2_longVideoFaceCropped/longVideoFaceCropped/s16/16_0402beatingpregnantwoman,macro-expression,1,3932,3943,4370,11
2,./CAS(ME)2_longVideoFaceCropped/longVideoFaceCropped/s16/16_0502funnyerrors,macro-expression,1,338,373,2274,35
2,./CAS(ME)2_longVideoFaceCropped/longVideoFaceCropped/s16/16_0502funnyerrors,macro-expression,1,850,894,2274,44
2,./CAS(ME)2_longVideoFaceCropped/longVideoFaceCropped/s16/16_0502funnyerrors,macro-expression,1,1098,1148,2274,50
2,./CAS(ME)2_longVideoFaceCropped/longVideoFaceCropped/s16/16_0502funnyerrors,macro-expression,1,1405,1441,2274,36
2,./CAS(ME)2_longVideoFaceCropped/longVideoFaceCropped/s16/16_0502funnyerrors,macro-expression,1,1470,1523,2274,53
2,./CAS(ME)2_longVideoFaceCropped/longVideoFaceCropped/s16/16_0502funnyerrors,macro-expression,1,2193,2220,2274,27
2,./CAS(ME)2_longVideoFaceCropped/longVideoFaceCropped/s16/16_0502funnyerrors,micro-expression,2,323,334,2274,11
2,./CAS(ME)2_longVideoFaceCropped/longVideoFaceCropped/s16/16_0505funnyinnovations,macro-expression,1,68,89,2303,21
2,./CAS(ME)2_longVideoFaceCropped/longVideoFaceCropped/s16/16_0505funnyinnovations,macro-expression,1,991,997,2303,6
2,./CAS(ME)2_longVideoFaceCropped/longVideoFaceCropped/s16/16_0505funnyinnovations,macro-expression,1,1135,1205,2303,70
2,./CAS(ME)2_longVideoFaceCropped/longVideoFaceCropped/s16/16_0505funnyinnovations,macro-expression,1,1352,1388,2303,36
2,./CAS(ME)2_longVideoFaceCropped/longVideoFaceCropped/s16/16_0505funnyinnovations,macro-expression,1,1595,1615,2303,20
2,./CAS(ME)2_longVideoFaceCropped/longVideoFaceCropped/s16/16_0505funnyinnovations,macro-expression,1,1610,1678,2303,68
2,./CAS(ME)2_longVideoFaceCropped/longVideoFaceCropped/s16/16_0505funnyinnovations,micro-expression,2,396,407,2303,11
2,./CAS(ME)2_longVideoFaceCropped/longVideoFaceCropped/s16/16_0505funnyinnovations,micro-expression,2,1695,1710,2303,15
2,./CAS(ME)2_longVideoFaceCropped/longVideoFaceCropped/s16/16_0505funnyinnovations,micro-expression,2,1880,1895,2303,15
2,./CAS(ME)2_longVideoFaceCropped/longVideoFaceCropped/s16/16_0507climbingthewall,macro-expression,1,844,870,3264,26
2,./CAS(ME)2_longVideoFaceCropped/longVideoFaceCropped/s16/16_0507climbingthewall,macro-expression,1,1571,1633,3264,62
2,./CAS(ME)2_longVideoFaceCropped/longVideoFaceCropped/s16/16_0507climbingthewall,macro-expression,1,2338,2411,3264,73
2,./CAS(ME)2_longVideoFaceCropped/longVideoFaceCropped/s16/16_0507climbingthewall,macro-expression,1,3169,3215,3264,46
2,./CAS(ME)2_longVideoFaceCropped/longVideoFaceCropped/s16/16_0507climbingthewall,micro-expression,2,1958,1968,3264,10
2,./CAS(ME)2_longVideoFaceCropped/longVideoFaceCropped/s16/16_0507climbingthewall,micro-expression,2,2285,2295,3264,10
3,./CAS(ME)2_longVideoFaceCropped/longVideoFaceCropped/s19/19_0102eatingworms,macro-expression,1,822,865,1070,43
3,./CAS(ME)2_longVideoFaceCropped/longVideoFaceCropped/s19/19_0102eatingworms,macro-expression,1,887,926,1070,39
3,./CAS(ME)2_longVideoFaceCropped/longVideoFaceCropped/s19/19_0402beatingpregnantwoman,micro-expression,2,1927,1942,4371,15
3,./CAS(ME)2_longVideoFaceCropped/longVideoFaceCropped/s19/19_0505funnyinnovations,macro-expression,1,1755,1808,2304,53
3,./CAS(ME)2_longVideoFaceCropped/longVideoFaceCropped/s19/19_0507climbingthewall,macro-expression,1,2977,3039,3265,62
4,./CAS(ME)2_longVideoFaceCropped/longVideoFaceCropped/s20/20_0502funnyerrors,macro-expression,1,981,999,2274,18
4,./CAS(ME)2_longVideoFaceCropped/longVideoFaceCropped/s20/20_0502funnyerrors,macro-expression,1,1125,1161,2274,36
4,./CAS(ME)2_longVideoFaceCropped/longVideoFaceCropped/s20/20_0502funnyerrors,macro-expression,1,1403,1499,2274,96
5,./CAS(ME)2_longVideoFaceCropped/longVideoFaceCropped/s21/21_0101disgustingteeth,macro-expression,1,169,191,2053,22
5,./CAS(ME)2_longVideoFaceCropped/longVideoFaceCropped/s21/21_0401girlcrashing,macro-expression,1,3379,3411,3716,32
6,./CAS(ME)2_longVideoFaceCropped/longVideoFaceCropped/s22/22_0101disgustingteeth,macro-expression,1,366,393,2052,27
6,./CAS(ME)2_longVideoFaceCropped/longVideoFaceCropped/s22/22_0101disgustingteeth,macro-expression,1,380,391,2052,11
6,./CAS(ME)2_longVideoFaceCropped/longVideoFaceCropped/s22/22_0101disgustingteeth,macro-expression,1,510,525,2052,15
6,./CAS(ME)2_longVideoFaceCropped/longVideoFaceCropped/s22/22_0101disgustingteeth,macro-expression,1,1562,1580,2052,18
6,./CAS(ME)2_longVideoFaceCropped/longVideoFaceCropped/s22/22_0101disgustingteeth,macro-expression,1,1573,1578,2052,5
6,./CAS(ME)2_longVideoFaceCropped/longVideoFaceCropped/s22/22_0101disgustingteeth,macro-expression,1,1645,1650,2052,5
6,./CAS(ME)2_longVideoFaceCropped/longVideoFaceCropped/s22/22_0101disgustingteeth,macro-expression,1,1706,1728,2052,22
6,./CAS(ME)2_longVideoFaceCropped/longVideoFaceCropped/s22/22_0101disgustingteeth,macro-expression,1,1752,1768,2052,16
6,./CAS(ME)2_longVideoFaceCropped/longVideoFaceCropped/s22/22_0101disgustingteeth,macro-expression,1,1822,1855,2052,33
6,./CAS(ME)2_longVideoFaceCropped/longVideoFaceCropped/s22/22_0102eatingworms,macro-expression,1,301,320,1072,19
6,./CAS(ME)2_longVideoFaceCropped/longVideoFaceCropped/s22/22_0102eatingworms,macro-expression,1,321,337,1072,16
6,./CAS(ME)2_longVideoFaceCropped/longVideoFaceCropped/s22/22_0102eatingworms,macro-expression,1,904,912,1072,8
6,./CAS(ME)2_longVideoFaceCropped/longVideoFaceCropped/s22/22_0402beatingpregnantwoman,macro-expression,1,3246,3270,4370,24
6,./CAS(ME)2_longVideoFaceCropped/longVideoFaceCropped/s22/22_0503unnyfarting,macro-expression,1,2758,2774,2811,16
6,./CAS(ME)2_longVideoFaceCropped/longVideoFaceCropped/s22/22_0508funnydunkey,macro-expression,1,81,115,659,34
7,./CAS(ME)2_longVideoFaceCropped/longVideoFaceCropped/s23/23_0102eatingworms,macro-expression,1,913,940,1071,27
7,./CAS(ME)2_longVideoFaceCropped/longVideoFaceCropped/s23/23_0102eatingworms,macro-expression,1,997,1015,1071,18
7,./CAS(ME)2_longVideoFaceCropped/longVideoFaceCropped/s23/23_0102eatingworms,micro-expression,2,331,346,1071,15
7,./CAS(ME)2_longVideoFaceCropped/longVideoFaceCropped/s23/23_0102eatingworms,micro-expression,2,526,540,1071,14
7,./CAS(ME)2_longVideoFaceCropped/longVideoFaceCropped/s23/23_0102eatingworms,micro-expression,2,727,740,1071,13
7,./CAS(ME)2_longVideoFaceCropped/longVideoFaceCropped/s23/23_0402beatingpregnantwoman,macro-expression,1,3685,3719,4374,34
7,./CAS(ME)2_longVideoFaceCropped/longVideoFaceCropped/s23/23_0402beatingpregnantwoman,macro-expression,1,3799,3818,4374,19
7,./CAS(ME)2_longVideoFaceCropped/longVideoFaceCropped/s23/23_0402beatingpregnantwoman,macro-expression,1,3879,3903,4374,24
7,./CAS(ME)2_longVideoFaceCropped/longVideoFaceCropped/s23/23_0502funnyerrors,macro-expression,1,1381,1460,2273,79
7,./CAS(ME)2_longVideoFaceCropped/longVideoFaceCropped/s23/23_0502funnyerrors,macro-expression,1,1937,1963,2273,26
7,./CAS(ME)2_longVideoFaceCropped/longVideoFaceCropped/s23/23_0507climbingthewall,macro-expression,1,2744,2764,3265,20
8,./CAS(ME)2_longVideoFaceCropped/longVideoFaceCropped/s24/24_0101disgustingteeth,macro-expression,1,1356,1380,2052,24
8,./CAS(ME)2_longVideoFaceCropped/longVideoFaceCropped/s24/24_0101disgustingteeth,macro-expression,1,1383,1419,2052,36
8,./CAS(ME)2_longVideoFaceCropped/longVideoFaceCropped/s24/24_0401girlcrashing,macro-expression,1,355,385,3717,30
8,./CAS(ME)2_longVideoFaceCropped/longVideoFaceCropped/s24/24_0401girlcrashing,macro-expression,1,434,450,3717,16
8,./CAS(ME)2_longVideoFaceCropped/longVideoFaceCropped/s24/24_0401girlcrashing,macro-expression,1,1262,1269,3717,7
8,./CAS(ME)2_longVideoFaceCropped/longVideoFaceCropped/s24/24_0401girlcrashing,macro-expression,1,1903,1950,3717,47
8,./CAS(ME)2_longVideoFaceCropped/longVideoFaceCropped/s24/24_0401girlcrashing,macro-expression,1,2208,2276,3717,68
8,./CAS(ME)2_longVideoFaceCropped/longVideoFaceCropped/s24/24_0401girlcrashing,micro-expression,2,608,621,3717,13
8,./CAS(ME)2_longVideoFaceCropped/longVideoFaceCropped/s24/24_0401girlcrashing,micro-expression,2,963,977,3717,14
8,./CAS(ME)2_longVideoFaceCropped/longVideoFaceCropped/s24/24_0401girlcrashing,micro-expression,2,1890,1902,3717,12
8,./CAS(ME)2_longVideoFaceCropped/longVideoFaceCropped/s24/24_0401girlcrashing,micro-expression,2,2181,2193,3717,12
8,./CAS(ME)2_longVideoFaceCropped/longVideoFaceCropped/s24/24_0402beatingpregnantwoman,macro-expression,1,3297,3342,4371,45
8,./CAS(ME)2_longVideoFaceCropped/longVideoFaceCropped/s24/24_0402beatingpregnantwoman,macro-expression,1,3553,3599,4371,46
8,./CAS(ME)2_longVideoFaceCropped/longVideoFaceCropped/s24/24_0502funnyerrors,macro-expression,1,852,869,2273,17
8,./CAS(ME)2_longVideoFaceCropped/longVideoFaceCropped/s24/24_0502funnyerrors,macro-expression,1,1078,1101,2273,23
8,./CAS(ME)2_longVideoFaceCropped/longVideoFaceCropped/s24/24_0502funnyerrors,macro-expression,1,1584,1630,2273,46
8,./CAS(ME)2_longVideoFaceCropped/longVideoFaceCropped/s24/24_0502funnyerrors,macro-expression,1,1863,1889,2273,26
8,./CAS(ME)2_longVideoFaceCropped/longVideoFaceCropped/s24/24_0507climbingthewall,macro-expression,1,832,881,3265,49
8,./CAS(ME)2_longVideoFaceCropped/longVideoFaceCropped/s24/24_0507climbingthewall,macro-expression,1,1421,1464,3265,43
8,./CAS(ME)2_longVideoFaceCropped/longVideoFaceCropped/s24/24_0507climbingthewall,macro-expression,1,1648,1658,3265,10
8,./CAS(ME)2_longVideoFaceCropped/longVideoFaceCropped/s24/24_0507climbingthewall,macro-expression,1,1664,1703,3265,39
8,./CAS(ME)2_longVideoFaceCropped/longVideoFaceCropped/s24/24_0507climbingthewall,macro-expression,1,1858,1882,3265,24
8,./CAS(ME)2_longVideoFaceCropped/longVideoFaceCropped/s24/24_0507climbingthewall,macro-expression,1,2005,2044,3265,39
8,./CAS(ME)2_longVideoFaceCropped/longVideoFaceCropped/s24/24_0507climbingthewall,macro-expression,1,2229,2247,3265,18
8,./CAS(ME)2_longVideoFaceCropped/longVideoFaceCropped/s24/24_0507climbingthewall,micro-expression,2,1836,1848,3265,12
8,./CAS(ME)2_longVideoFaceCropped/longVideoFaceCropped/s24/24_0507climbingthewall,micro-expression,2,1951,1965,3265,14
9,./CAS(ME)2_longVideoFaceCropped/longVideoFaceCropped/s25/25_0101disgustingteeth,micro-expression,2,113,127,2054,14
9,./CAS(ME)2_longVideoFaceCropped/longVideoFaceCropped/s25/25_0102eatingworms,macro-expression,1,470,490,1075,20
9,./CAS(ME)2_longVideoFaceCropped/longVideoFaceCropped/s25/25_0102eatingworms,micro-expression,2,996,1008,1075,12
9,./CAS(ME)2_longVideoFaceCropped/longVideoFaceCropped/s25/25_0102eatingworms,micro-expression,2,1008,1017,1075,9
9,./CAS(ME)2_longVideoFaceCropped/longVideoFaceCropped/s25/25_0102eatingworms,micro-expression,2,1018,1034,1075,16
9,./CAS(ME)2_longVideoFaceCropped/longVideoFaceCropped/s25/25_0502funnyerrors,macro-expression,1,841,913,2274,72
9,./CAS(ME)2_longVideoFaceCropped/longVideoFaceCropped/s25/25_0502funnyerrors,macro-expression,1,945,984,2274,39
9,./CAS(ME)2_longVideoFaceCropped/longVideoFaceCropped/s25/25_0508funnydunkey,macro-expression,1,123,167,660,44
9,./CAS(ME)2_longVideoFaceCropped/longVideoFaceCropped/s25/25_0508funnydunkey,macro-expression,1,189,203,660,14
10,./CAS(ME)2_longVideoFaceCropped/longVideoFaceCropped/s26/26_0101disgustingteeth,macro-expression,1,1014,1040,2052,26
10,./CAS(ME)2_longVideoFaceCropped/longVideoFaceCropped/s26/26_0102eatingworms,macro-expression,1,308,345,1070,37
10,./CAS(ME)2_longVideoFaceCropped/longVideoFaceCropped/s26/26_0102eatingworms,macro-expression,1,428,447,1070,19
10,./CAS(ME)2_longVideoFaceCropped/longVideoFaceCropped/s26/26_0401girlcrashing,macro-expression,1,575,622,3714,47
10,./CAS(ME)2_longVideoFaceCropped/longVideoFaceCropped/s26/26_0503unnyfarting,macro-expression,1,408,438,2811,30
10,./CAS(ME)2_longVideoFaceCropped/longVideoFaceCropped/s26/26_0503unnyfarting,macro-expression,1,1727,1757,2811,30
11,./CAS(ME)2_longVideoFaceCropped/longVideoFaceCropped/s27/27_0101disgustingteeth,macro-expression,1,417,473,2052,56
11,./CAS(ME)2_longVideoFaceCropped/longVideoFaceCropped/s27/27_0101disgustingteeth,macro-expression,1,890,911,2052,21
11,./CAS(ME)2_longVideoFaceCropped/longVideoFaceCropped/s27/27_0101disgustingteeth,macro-expression,1,1201,1220,2052,19
11,./CAS(ME)2_longVideoFaceCropped/longVideoFaceCropped/s27/27_0101disgustingteeth,macro-expression,1,1221,1224,2052,3
11,./CAS(ME)2_longVideoFaceCropped/longVideoFaceCropped/s27/27_0101disgustingteeth,macro-expression,1,1703,1722,2052,19
11,./CAS(ME)2_longVideoFaceCropped/longVideoFaceCropped/s27/27_0101disgustingteeth,micro-expression,2,874,888,2052,14
11,./CAS(ME)2_longVideoFaceCropped/longVideoFaceCropped/s27/27_0102eatingworms,macro-expression,1,314,332,1076,18
11,./CAS(ME)2_longVideoFaceCropped/longVideoFaceCropped/s27/27_0102eatingworms,macro-expression,1,439,457,1076,18
11,./CAS(ME)2_longVideoFaceCropped/longVideoFaceCropped/s27/27_0102eatingworms,macro-expression,1,452,509,1076,57
11,./CAS(ME)2_longVideoFaceCropped/longVideoFaceCropped/s27/27_0102eatingworms,macro-expression,1,553,572,1076,19
11,./CAS(ME)2_longVideoFaceCropped/longVideoFaceCropped/s27/27_0102eatingworms,macro-expression,1,795,818,1076,23
11,./CAS(ME)2_longVideoFaceCropped/longVideoFaceCropped/s27/27_0102eatingworms,macro-expression,1,1053,1074,1076,21
11,./CAS(ME)2_longVideoFaceCropped/longVideoFaceCropped/s27/27_0102eatingworms,micro-expression,2,34,48,1076,14
11,./CAS(ME)2_longVideoFaceCropped/longVideoFaceCropped/s27/27_0102eatingworms,micro-expression,2,309,317,1076,8
11,./CAS(ME)2_longVideoFaceCropped/longVideoFaceCropped/s27/27_0102eatingworms,micro-expression,2,374,388,1076,14
11,./CAS(ME)2_longVideoFaceCropped/longVideoFaceCropped/s27/27_0401girlcrashing,macro-expression,1,1152,1177,3712,25
11,./CAS(ME)2_longVideoFaceCropped/longVideoFaceCropped/s27/27_0401girlcrashing,macro-expression,1,1682,1733,3712,51
11,./CAS(ME)2_longVideoFaceCropped/longVideoFaceCropped/s27/27_0401girlcrashing,macro-expression,1,2158,2182,3712,24
11,./CAS(ME)2_longVideoFaceCropped/longVideoFaceCropped/s27/27_0401girlcrashing,macro-expression,1,2241,2258,3712,17
11,./CAS(ME)2_longVideoFaceCropped/longVideoFaceCropped/s27/27_0401girlcrashing,micro-expression,2,352,365,3712,13
11,./CAS(ME)2_longVideoFaceCropped/longVideoFaceCropped/s27/27_0401girlcrashing,micro-expression,2,369,382,3712,13
11,./CAS(ME)2_longVideoFaceCropped/longVideoFaceCropped/s27/27_0401girlcrashing,micro-expression,2,1135,1147,3712,12
11,./CAS(ME)2_longVideoFaceCropped/longVideoFaceCropped/s27/27_0401girlcrashing,micro-expression,2,1974,1986,3712,12
11,./CAS(ME)2_longVideoFaceCropped/longVideoFaceCropped/s27/27_0402beatingpregnantwoman,macro-expression,1,2632,2653,4371,21
11,./CAS(ME)2_longVideoFaceCropped/longVideoFaceCropped/s27/27_0402beatingpregnantwoman,macro-expression,1,3727,3745,4371,18
11,./CAS(ME)2_longVideoFaceCropped/longVideoFaceCropped/s27/27_0502funnyerrors,macro-expression,1,169,251,2273,82
11,./CAS(ME)2_longVideoFaceCropped/longVideoFaceCropped/s27/27_0502funnyerrors,macro-expression,1,329,341,2273,12
11,./CAS(ME)2_longVideoFaceCropped/longVideoFaceCropped/s27/27_0502funnyerrors,macro-expression,1,558,599,2273,41
11,./CAS(ME)2_longVideoFaceCropped/longVideoFaceCropped/s27/27_0502funnyerrors,macro-expression,1,1081,1133,2273,52
11,./CAS(ME)2_longVideoFaceCropped/longVideoFaceCropped/s27/27_0502funnyerrors,macro-expression,1,1438,1465,2273,27
11,./CAS(ME)2_longVideoFaceCropped/longVideoFaceCropped/s27/27_0502funnyerrors,macro-expression,1,2187,2219,2273,32
11,./CAS(ME)2_longVideoFaceCropped/longVideoFaceCropped/s27/27_0502funnyerrors,micro-expression,2,613,628,2273,15
11,./CAS(ME)2_longVideoFaceCropped/longVideoFaceCropped/s27/27_0503unnyfarting,macro-expression,1,359,394,2810,35
11,./CAS(ME)2_longVideoFaceCropped/longVideoFaceCropped/s27/27_0503unnyfarting,macro-expression,1,2225,2271,2810,46
11,./CAS(ME)2_longVideoFaceCropped/longVideoFaceCropped/s27/27_0503unnyfarting,micro-expression,2,419,432,2810,13
11,./CAS(ME)2_longVideoFaceCropped/longVideoFaceCropped/s27/27_0505funnyinnovations,macro-expression,1,1122,1234,2304,112
11,./CAS(ME)2_longVideoFaceCropped/longVideoFaceCropped/s27/27_0505funnyinnovations,macro-expression,1,1758,1813,2304,55
11,./CAS(ME)2_longVideoFaceCropped/longVideoFaceCropped/s27/27_0505funnyinnovations,macro-expression,1,1918,1982,2304,64
11,./CAS(ME)2_longVideoFaceCropped/longVideoFaceCropped/s27/27_0507climbingthewall,macro-expression,1,901,919,3265,18
11,./CAS(ME)2_longVideoFaceCropped/longVideoFaceCropped/s27/27_0507climbingthewall,macro-expression,1,2677,2702,3265,25
11,./CAS(ME)2_longVideoFaceCropped/longVideoFaceCropped/s27/27_0507climbingthewall,macro-expression,1,3187,3212,3265,25
11,./CAS(ME)2_longVideoFaceCropped/longVideoFaceCropped/s27/27_0507climbingthewall,micro-expression,2,876,890,3265,14
11,./CAS(ME)2_longVideoFaceCropped/longVideoFaceCropped/s27/27_0508funnydunkey,macro-expression,1,179,243,660,64
12,./CAS(ME)2_longVideoFaceCropped/longVideoFaceCropped/s29/29_0502funnyerrors,micro-expression,2,140,152,2275,12
13,./CAS(ME)2_longVideoFaceCropped/longVideoFaceCropped/s30/30_0101disgustingteeth,micro-expression,2,1455,1466,2051,11
13,./CAS(ME)2_longVideoFaceCropped/longVideoFaceCropped/s30/30_0102eatingworms,macro-expression,1,337,385,1069,48
13,./CAS(ME)2_longVideoFaceCropped/longVideoFaceCropped/s30/30_0102eatingworms,macro-expression,1,761,804,1069,43
13,./CAS(ME)2_longVideoFaceCropped/longVideoFaceCropped/s30/30_0401girlcrashing,macro-expression,1,395,422,3716,27
13,./CAS(ME)2_longVideoFaceCropped/longVideoFaceCropped/s30/30_0401girlcrashing,macro-expression,1,1581,1622,3716,41
13,./CAS(ME)2_longVideoFaceCropped/longVideoFaceCropped/s30/30_0401girlcrashing,macro-expression,1,2983,3021,3716,38
13,./CAS(ME)2_longVideoFaceCropped/longVideoFaceCropped/s30/30_0401girlcrashing,micro-expression,2,926,941,3716,15
13,./CAS(ME)2_longVideoFaceCropped/longVideoFaceCropped/s30/30_0502funnyerrors,macro-expression,1,167,197,2274,30
13,./CAS(ME)2_longVideoFaceCropped/longVideoFaceCropped/s30/30_0502funnyerrors,macro-expression,1,331,410,2274,79
13,./CAS(ME)2_longVideoFaceCropped/longVideoFaceCropped/s30/30_0502funnyerrors,macro-expression,1,846,895,2274,49
13,./CAS(ME)2_longVideoFaceCropped/longVideoFaceCropped/s30/30_0502funnyerrors,macro-expression,1,1172,1195,2274,23
13,./CAS(ME)2_longVideoFaceCropped/longVideoFaceCropped/s30/30_0502funnyerrors,macro-expression,1,1569,1614,2274,45
13,./CAS(ME)2_longVideoFaceCropped/longVideoFaceCropped/s30/30_0502funnyerrors,macro-expression,1,1918,1954,2274,36
13,./CAS(ME)2_longVideoFaceCropped/longVideoFaceCropped/s30/30_0503unnyfarting,macro-expression,1,1419,1438,2810,19
13,./CAS(ME)2_longVideoFaceCropped/longVideoFaceCropped/s30/30_0503unnyfarting,macro-expression,1,1547,1562,2810,15
13,./CAS(ME)2_longVideoFaceCropped/longVideoFaceCropped/s30/30_0505funnyinnovations,macro-expression,1,1141,1166,2303,25
13,./CAS(ME)2_longVideoFaceCropped/longVideoFaceCropped/s30/30_0505funnyinnovations,macro-expression,1,2232,2302,2303,70
13,./CAS(ME)2_longVideoFaceCropped/longVideoFaceCropped/s30/30_0507climbingthewall,macro-expression,1,1680,1698,3264,18
13,./CAS(ME)2_longVideoFaceCropped/longVideoFaceCropped/s30/30_0507climbingthewall,macro-expression,1,3179,3193,3264,14
14,./CAS(ME)2_longVideoFaceCropped/longVideoFaceCropped/s31/31_0101disgustingteeth,macro-expression,1,382,457,2051,75
14,./CAS(ME)2_longVideoFaceCropped/longVideoFaceCropped/s31/31_0101disgustingteeth,macro-expression,1,555,611,2051,56
14,./CAS(ME)2_longVideoFaceCropped/longVideoFaceCropped/s31/31_0101disgustingteeth,macro-expression,1,726,843,2051,117
14,./CAS(ME)2_longVideoFaceCropped/longVideoFaceCropped/s31/31_0101disgustingteeth,macro-expression,1,836,886,2051,50
14,./CAS(ME)2_longVideoFaceCropped/longVideoFaceCropped/s31/31_0101disgustingteeth,macro-expression,1,1089,1140,2051,51
14,./CAS(ME)2_longVideoFaceCropped/longVideoFaceCropped/s31/31_0101disgustingteeth,macro-expression,1,1150,1169,2051,19
14,./CAS(ME)2_longVideoFaceCropped/longVideoFaceCropped/s31/31_0101disgustingteeth,macro-expression,1,1561,1601,2051,40
14,./CAS(ME)2_longVideoFaceCropped/longVideoFaceCropped/s31/31_0101disgustingteeth,macro-expression,1,1631,1640,2051,9
14,./CAS(ME)2_longVideoFaceCropped/longVideoFaceCropped/s31/31_0101disgustingteeth,micro-expression,2,1421,1433,2051,12
14,./CAS(ME)2_longVideoFaceCropped/longVideoFaceCropped/s31/31_0401girlcrashing,macro-expression,1,515,534,3712,19
14,./CAS(ME)2_longVideoFaceCropped/longVideoFaceCropped/s31/31_0401girlcrashing,macro-expression,1,2850,2876,3712,26
14,./CAS(ME)2_longVideoFaceCropped/longVideoFaceCropped/s31/31_0401girlcrashing,macro-expression,1,3337,3383,3712,46
14,./CAS(ME)2_longVideoFaceCropped/longVideoFaceCropped/s31/31_0402beatingpregnantwoman,macro-expression,1,863,888,4371,25
14,./CAS(ME)2_longVideoFaceCropped/longVideoFaceCropped/s31/31_0402beatingpregnantwoman,macro-expression,1,2123,2156,4371,33
14,./CAS(ME)2_longVideoFaceCropped/longVideoFaceCropped/s31/31_0402beatingpregnantwoman,macro-expression,1,2205,2226,4371,21
14,./CAS(ME)2_longVideoFaceCropped/longVideoFaceCropped/s31/31_0402beatingpregnantwoman,macro-expression,1,2395,2450,4371,55
14,./CAS(ME)2_longVideoFaceCropped/longVideoFaceCropped/s31/31_0402beatingpregnantwoman,macro-expression,1,3277,3351,4371,74
14,./CAS(ME)2_longVideoFaceCropped/longVideoFaceCropped/s31/31_0402beatingpregnantwoman,macro-expression,1,3479,3509,4371,30
14,./CAS(ME)2_longVideoFaceCropped/longVideoFaceCropped/s31/31_0402beatingpregnantwoman,micro-expression,2,1689,1702,4371,13
14,./CAS(ME)2_longVideoFaceCropped/longVideoFaceCropped/s31/31_0402beatingpregnantwoman,micro-expression,2,2190,2204,4371,14
14,./CAS(ME)2_longVideoFaceCropped/longVideoFaceCropped/s31/31_0402beatingpregnantwoman,micro-expression,2,2377,2389,4371,12
14,./CAS(ME)2_longVideoFaceCropped/longVideoFaceCropped/s31/31_0502funnyerrors,macro-expression,1,1595,1653,2273,58
14,./CAS(ME)2_longVideoFaceCropped/longVideoFaceCropped/s31/31_0503unnyfarting,macro-expression,1,2169,2202,2810,33
14,./CAS(ME)2_longVideoFaceCropped/longVideoFaceCropped/s31/31_0505funnyinnovations,macro-expression,1,2242,2279,2303,37
14,./CAS(ME)2_longVideoFaceCropped/longVideoFaceCropped/s31/31_0505funnyinnovations,micro-expression,2,1046,1059,2303,13
14,./CAS(ME)2_longVideoFaceCropped/longVideoFaceCropped/s31/31_0507climbingthewall,macro-expression,1,768,793,3265,25
14,./CAS(ME)2_longVideoFaceCropped/longVideoFaceCropped/s31/31_0507climbingthewall,macro-expression,1,834,857,3265,23
14,./CAS(ME)2_longVideoFaceCropped/longVideoFaceCropped/s31/31_0507climbingthewall,macro-expression,1,1500,1520,3265,20
14,./CAS(ME)2_longVideoFaceCropped/longVideoFaceCropped/s31/31_0507climbingthewall,macro-expression,1,1565,1586,3265,21
14,./CAS(ME)2_longVideoFaceCropped/longVideoFaceCropped/s31/31_0507climbingthewall,macro-expression,1,2247,2268,3265,21
14,./CAS(ME)2_longVideoFaceCropped/longVideoFaceCropped/s31/31_0507climbingthewall,macro-expression,1,3114,3144,3265,30
15,./CAS(ME)2_longVideoFaceCropped/longVideoFaceCropped/s32/32_0101disgustingteeth,macro-expression,1,885,919,2053,34
15,./CAS(ME)2_longVideoFaceCropped/longVideoFaceCropped/s32/32_0101disgustingteeth,macro-expression,1,1234,1250,2053,16
15,./CAS(ME)2_longVideoFaceCropped/longVideoFaceCropped/s32/32_0102eatingworms,macro-expression,1,780,802,1071,22
15,./CAS(ME)2_longVideoFaceCropped/longVideoFaceCropped/s32/32_0401girlcrashing,macro-expression,1,302,322,3717,20
15,./CAS(ME)2_longVideoFaceCropped/longVideoFaceCropped/s32/32_0401girlcrashing,macro-expression,1,344,360,3717,16
15,./CAS(ME)2_longVideoFaceCropped/longVideoFaceCropped/s32/32_0401girlcrashing,macro-expression,1,406,439,3717,33
15,./CAS(ME)2_longVideoFaceCropped/longVideoFaceCropped/s32/32_0401girlcrashing,macro-expression,1,562,609,3717,47
15,./CAS(ME)2_longVideoFaceCropped/longVideoFaceCropped/s32/32_0401girlcrashing,macro-expression,1,874,897,3717,23
15,./CAS(ME)2_longVideoFaceCropped/longVideoFaceCropped/s32/32_0401girlcrashing,macro-expression,1,1310,1363,3717,53
15,./CAS(ME)2_longVideoFaceCropped/longVideoFaceCropped/s32/32_0401girlcrashing,macro-expression,1,1518,1560,3717,42
15,./CAS(ME)2_longVideoFaceCropped/longVideoFaceCropped/s32/32_0401girlcrashing,macro-expression,1,1650,1674,3717,24
15,./CAS(ME)2_longVideoFaceCropped/longVideoFaceCropped/s32/32_0401girlcrashing,micro-expression,2,268,278,3717,10
15,./CAS(ME)2_longVideoFaceCropped/longVideoFaceCropped/s32/32_0402beatingpregnantwoman,macro-expression,1,1531,1550,4374,19
15,./CAS(ME)2_longVideoFaceCropped/longVideoFaceCropped/s32/32_0402beatingpregnantwoman,macro-expression,1,2270,2295,4374,25
15,./CAS(ME)2_longVideoFaceCropped/longVideoFaceCropped/s32/32_0402beatingpregnantwoman,macro-expression,1,2774,2802,4374,28
15,./CAS(ME)2_longVideoFaceCropped/longVideoFaceCropped/s32/32_0402beatingpregnantwoman,macro-expression,1,3200,3210,4374,10
15,./CAS(ME)2_longVideoFaceCropped/longVideoFaceCropped/s32/32_0402beatingpregnantwoman,macro-expression,1,3396,3426,4374,30
15,./CAS(ME)2_longVideoFaceCropped/longVideoFaceCropped/s32/32_0402beatingpregnantwoman,macro-expression,1,3745,3807,4374,62
15,./CAS(ME)2_longVideoFaceCropped/longVideoFaceCropped/s32/32_0402beatingpregnantwoman,macro-expression,1,3999,4073,4374,74
15,./CAS(ME)2_longVideoFaceCropped/longVideoFaceCropped/s32/32_0502funnyerrors,macro-expression,1,139,194,2274,55
15,./CAS(ME)2_longVideoFaceCropped/longVideoFaceCropped/s32/32_0502funnyerrors,macro-expression,1,325,345,2274,20
15,./CAS(ME)2_longVideoFaceCropped/longVideoFaceCropped/s32/32_0502funnyerrors,macro-expression,1,404,410,2274,6
15,./CAS(ME)2_longVideoFaceCropped/longVideoFaceCropped/s32/32_0502funnyerrors,macro-expression,1,858,909,2274,51
15,./CAS(ME)2_longVideoFaceCropped/longVideoFaceCropped/s32/32_0502funnyerrors,macro-expression,1,1570,1609,2274,39
15,./CAS(ME)2_longVideoFaceCropped/longVideoFaceCropped/s32/32_0502funnyerrors,macro-expression,1,2203,2229,2274,26
15,./CAS(ME)2_longVideoFaceCropped/longVideoFaceCropped/s32/32_0502funnyerrors,micro-expression,2,311,324,2274,13
15,./CAS(ME)2_longVideoFaceCropped/longVideoFaceCropped/s32/32_0502funnyerrors,micro-expression,2,1171,1184,2274,13
15,./CAS(ME)2_longVideoFaceCropped/longVideoFaceCropped/s32/32_0503unnyfarting,macro-expression,1,258,319,2811,61
15,./CAS(ME)2_longVideoFaceCropped/longVideoFaceCropped/s32/32_0503unnyfarting,macro-expression,1,349,416,2811,67
15,./CAS(ME)2_longVideoFaceCropped/longVideoFaceCropped/s32/32_0503unnyfarting,macro-expression,1,656,716,2811,60
15,./CAS(ME)2_longVideoFaceCropped/longVideoFaceCropped/s32/32_0503unnyfarting,macro-expression,1,729,755,2811,26
15,./CAS(ME)2_longVideoFaceCropped/longVideoFaceCropped/s32/32_0503unnyfarting,macro-expression,1,748,820,2811,72
15,./CAS(ME)2_longVideoFaceCropped/longVideoFaceCropped/s32/32_0503unnyfarting,macro-expression,1,1082,1143,2811,61
15,./CAS(ME)2_longVideoFaceCropped/longVideoFaceCropped/s32/32_0503unnyfarting,macro-expression,1,1552,1586,2811,34
15,./CAS(ME)2_longVideoFaceCropped/longVideoFaceCropped/s32/32_0503unnyfarting,micro-expression,2,258,272,2811,14
15,./CAS(ME)2_longVideoFaceCropped/longVideoFaceCropped/s32/32_0503unnyfarting,micro-expression,2,1031,1044,2811,13
15,./CAS(ME)2_longVideoFaceCropped/longVideoFaceCropped/s32/32_0505funnyinnovations,macro-expression,1,1362,1380,2304,18
15,./CAS(ME)2_longVideoFaceCropped/longVideoFaceCropped/s32/32_0505funnyinnovations,macro-expression,1,1382,1405,2304,23
15,./CAS(ME)2_longVideoFaceCropped/longVideoFaceCropped/s32/32_0505funnyinnovations,macro-expression,1,1709,1750,2304,41
15,./CAS(ME)2_longVideoFaceCropped/longVideoFaceCropped/s32/32_0505funnyinnovations,macro-expression,1,2212,2272,2304,60
15,./CAS(ME)2_longVideoFaceCropped/longVideoFaceCropped/s32/32_0507climbingthewall,macro-expression,1,1646,1743,3265,97
15,./CAS(ME)2_longVideoFaceCropped/longVideoFaceCropped/s32/32_0507climbingthewall,macro-expression,1,2332,2348,3265,16
15,./CAS(ME)2_longVideoFaceCropped/longVideoFaceCropped/s32/32_0508funnydunkey,micro-expression,2,286,301,660,15
16,./CAS(ME)2_longVideoFaceCropped/longVideoFaceCropped/s33/33_0102eatingworms,macro-expression,1,56,76,1072,20
16,./CAS(ME)2_longVideoFaceCropped/longVideoFaceCropped/s33/33_0102eatingworms,macro-expression,1,108,130,1072,22
16,./CAS(ME)2_longVideoFaceCropped/longVideoFaceCropped/s33/33_0402beatingpregnantwoman,macro-expression,1,3682,3699,4374,17
16,./CAS(ME)2_longVideoFaceCropped/longVideoFaceCropped/s33/33_0402beatingpregnantwoman,macro-expression,1,4328,4356,4374,28
17,./CAS(ME)2_longVideoFaceCropped/longVideoFaceCropped/s34/34_0401girlcrashing,macro-expression,1,1763,1787,3715,24
17,./CAS(ME)2_longVideoFaceCropped/longVideoFaceCropped/s34/34_0402beatingpregnantwoman,macro-expression,1,2170,2185,4371,15
17,./CAS(ME)2_longVideoFaceCropped/longVideoFaceCropped/s34/34_0503unnyfarting,macro-expression,1,990,1042,2811,52
18,./CAS(ME)2_longVideoFaceCropped/longVideoFaceCropped/s35/35_0102eatingworms,micro-expression,2,100,113,1081,13
18,./CAS(ME)2_longVideoFaceCropped/longVideoFaceCropped/s35/35_0102eatingworms,micro-expression,2,363,371,1081,8
19,./CAS(ME)2_longVideoFaceCropped/longVideoFaceCropped/s36/36_0401girlcrashing,macro-expression,1,106,145,3720,39
19,./CAS(ME)2_longVideoFaceCropped/longVideoFaceCropped/s36/36_0505funnyinnovations,macro-expression,1,348,373,2306,25
19,./CAS(ME)2_longVideoFaceCropped/longVideoFaceCropped/s36/36_0505funnyinnovations,macro-expression,1,566,582,2306,16
19,./CAS(ME)2_longVideoFaceCropped/longVideoFaceCropped/s36/36_0505funnyinnovations,macro-expression,1,1074,1095,2306,21
20,./CAS(ME)2_longVideoFaceCropped/longVideoFaceCropped/s37/37_0101disgustingteeth,macro-expression,1,1289,1310,2052,21
20,./CAS(ME)2_longVideoFaceCropped/longVideoFaceCropped/s37/37_0402beatingpregnantwoman,macro-expression,1,2783,2810,4371,27
20,./CAS(ME)2_longVideoFaceCropped/longVideoFaceCropped/s37/37_0402beatingpregnantwoman,macro-expression,1,3045,3066,4371,21
20,./CAS(ME)2_longVideoFaceCropped/longVideoFaceCropped/s37/37_0402beatingpregnantwoman,macro-expression,1,3176,3200,4371,24
20,./CAS(ME)2_longVideoFaceCropped/longVideoFaceCropped/s37/37_0402beatingpregnantwoman,macro-expression,1,3397,3413,4371,16
20,./CAS(ME)2_longVideoFaceCropped/longVideoFaceCropped/s37/37_0402beatingpregnantwoman,micro-expression,2,3502,3514,4371,12
20,./CAS(ME)2_longVideoFaceCropped/longVideoFaceCropped/s37/37_0502funnyerrors,macro-expression,1,851,875,2270,24
20,./CAS(ME)2_longVideoFaceCropped/longVideoFaceCropped/s37/37_0502funnyerrors,macro-expression,1,1858,1868,2270,10
20,./CAS(ME)2_longVideoFaceCropped/longVideoFaceCropped/s37/37_0505funnyinnovations,macro-expression,1,414,423,2306,9
20,./CAS(ME)2_longVideoFaceCropped/longVideoFaceCropped/s37/37_0505funnyinnovations,macro-expression,1,1167,1182,2306,15
20,./CAS(ME)2_longVideoFaceCropped/longVideoFaceCropped/s37/37_0505funnyinnovations,macro-expression,1,1468,1509,2306,41
20,./CAS(ME)2_longVideoFaceCropped/longVideoFaceCropped/s37/37_0505funnyinnovations,macro-expression,1,1511,1541,2306,30
20,./CAS(ME)2_longVideoFaceCropped/longVideoFaceCropped/s37/37_0505funnyinnovations,macro-expression,1,1941,1974,2306,33
20,./CAS(ME)2_longVideoFaceCropped/longVideoFaceCropped/s37/37_0505funnyinnovations,macro-expression,1,2229,2269,2306,40
20,./CAS(ME)2_longVideoFaceCropped/longVideoFaceCropped/s37/37_0507climbingthewall,macro-expression,1,846,861,3264,15
20,./CAS(ME)2_longVideoFaceCropped/longVideoFaceCropped/s37/37_0507climbingthewall,macro-expression,1,1571,1680,3264,109
20,./CAS(ME)2_longVideoFaceCropped/longVideoFaceCropped/s37/37_0507climbingthewall,macro-expression,1,1751,1762,3264,11
20,./CAS(ME)2_longVideoFaceCropped/longVideoFaceCropped/s37/37_0507climbingthewall,macro-expression,1,2020,2074,3264,54
20,./CAS(ME)2_longVideoFaceCropped/longVideoFaceCropped/s37/37_0507climbingthewall,macro-expression,1,2341,2400,3264,59
20,./CAS(ME)2_longVideoFaceCropped/longVideoFaceCropped/s37/37_0507climbingthewall,macro-expression,1,2688,2752,3264,64
20,./CAS(ME)2_longVideoFaceCropped/longVideoFaceCropped/s37/37_0508funnydunkey,macro-expression,1,233,255,660,22
20,./CAS(ME)2_longVideoFaceCropped/longVideoFaceCropped/s37/37_0508funnydunkey,macro-expression,1,322,333,660,11
20,./CAS(ME)2_longVideoFaceCropped/longVideoFaceCropped/s37/37_0508funnydunkey,micro-expression,2,418,430,660,12
21,./CAS(ME)2_longVideoFaceCropped/longVideoFaceCropped/s38/38_0502funnyerrors,macro-expression,1,329,342,2277,13
21,./CAS(ME)2_longVideoFaceCropped/longVideoFaceCropped/s38/38_0502funnyerrors,macro-expression,1,878,922,2277,44
21,./CAS(ME)2_longVideoFaceCropped/longVideoFaceCropped/s38/38_0502funnyerrors,macro-expression,1,962,981,2277,19
21,./CAS(ME)2_longVideoFaceCropped/longVideoFaceCropped/s38/38_0502funnyerrors,macro-expression,1,1189,1197,2277,8
21,./CAS(ME)2_longVideoFaceCropped/longVideoFaceCropped/s38/38_0502funnyerrors,macro-expression,1,1782,1841,2277,59
21,./CAS(ME)2_longVideoFaceCropped/longVideoFaceCropped/s38/38_0502funnyerrors,macro-expression,1,1869,1882,2277,13
21,./CAS(ME)2_longVideoFaceCropped/longVideoFaceCropped/s38/38_0507climbingthewall,macro-expression,1,1242,1263,3264,21
21,./CAS(ME)2_longVideoFaceCropped/longVideoFaceCropped/s38/38_0507climbingthewall,macro-expression,1,1377,1422,3264,45
21,./CAS(ME)2_longVideoFaceCropped/longVideoFaceCropped/s38/38_0507climbingthewall,macro-expression,1,1664,1703,3264,39
21,./CAS(ME)2_longVideoFaceCropped/longVideoFaceCropped/s38/38_0507climbingthewall,macro-expression,1,1775,1809,3264,34
21,./CAS(ME)2_longVideoFaceCropped/longVideoFaceCropped/s38/38_0507climbingthewall,macro-expression,1,1870,1911,3264,41
21,./CAS(ME)2_longVideoFaceCropped/longVideoFaceCropped/s38/38_0507climbingthewall,micro-expression,2,2232,2247,3264,15
22,./CAS(ME)2_longVideoFaceCropped/longVideoFaceCropped/s40/40_0401girlcrashing,macro-expression,1,392,415,3714,23
22,./CAS(ME)2_longVideoFaceCropped/longVideoFaceCropped/s40/40_0401girlcrashing,macro-expression,1,592,613,3714,21
22,./CAS(ME)2_longVideoFaceCropped/longVideoFaceCropped/s40/40_0502funnyerrors,macro-expression,1,601,613,2275,12
22,./CAS(ME)2_longVideoFaceCropped/longVideoFaceCropped/s40/40_0502funnyerrors,macro-expression,1,1598,1613,2275,15
22,./CAS(ME)2_longVideoFaceCropped/longVideoFaceCropped/s40/40_0503unnyfarting,macro-expression,1,2692,2707,2814,15
